WAFER_MAP        = {
Wafer_ID         =  "FMYK0-0129A-02"
Flat_Notch       =  180
ROWS             =  47
COLUMNS          =  58
WAFER_SIZE       =  200
Lot_ID           =  "FMYK0-0129A"
X_SIZE           =  3250
Y_SIZE           =  3986
PDPW(TOTAL DIES) =  2134
GOOD DIES        =  1544 "72.35%"
REJECT DIES      =  590 "27.65%"
BIN1  =  "1"  1544  "Pass"
BIN2  =  "2"  0  "Fail"
BIN3  =  "3"  0  "Fail"
BIN4  =  "4"  0  "Fail"
BIN5  =  "5"  102  "Fail"
BIN6  =  "6"  1  "Fail"
BIN7  =  "7"  89  "Fail"
BIN8  =  "8"  4  "Fail"
BIN9  =  "9"  339  "Fail"
BIN10 =  "A"  55  "Fail"
BIN11 =  "B"  0  "Fail"
BIN12 =  "C"  0  "Fail"
BIN13 =  "D"  0  "Fail"
BIN14 =  "E"  0  "Fail"
BIN15 =  "F"  0  "Fail"
BIN16 =  "G"  0  "Fail"
BIN17 =  "H"  0  "Fail"
BIN18 =  "I"  0  "Fail"
BIN19 =  "J"  0  "Fail"
BIN20 =  "K"  0  "Fail"
BIN21 =  "L"  0  "Fail"
BIN22 =  "M"  0  "Fail"
BIN23 =  "N"  0  "Fail"
BIN24 =  "O"  0  "Fail"
BIN25 =  "P"  0  "Fail"
BIN26 =  "Q"  0  "Fail"
BIN27 =  "R"  0  "Fail"
BIN28 =  "S"  0  "Fail"
BIN29 =  "T"  0  "Fail"
BIN30 =  "U"  0  "Fail"
BIN31 =  "V"  0  "Fail"
BIN32 =  "W"  0  "Fail"
BIN33 =  "X"  0  "Fail"
BIN34 =  "Y"  0  "Fail"
BIN35 =  "Z"  0  "Fail"
BIN36 =  "a"  0  "Fail"
BIN37 =  "b"  0  "Fail"
BIN38 =  "c"  0  "Fail"
BIN39 =  "d"  0  "Fail"
BIN40 =  "e"  0  "Fail"
BIN41 =  "f"  0  "Fail"
BIN42 =  "g"  0  "Fail"
BIN43 =  "h"  0  "Fail"
BIN44 =  "i"  0  "Fail"
BIN45 =  "j"  0  "Fail"
BIN46 =  "k"  0  "Fail"
BIN47 =  "m"  0  "Fail"
BIN48 =  "n"  0  "Fail"
BIN49 =  "o"  0  "Fail"
BIN50 =  "p"  0  "Fail"
BIN51 =  "q"  0  "Fail"
BIN52 =  "r"  0  "Fail"
BIN53 =  "s"  0  "Fail"
BIN54 =  "t"  0  "Fail"
BIN55 =  "u"  0  "Fail"
BIN56 =  "v"  0  "Fail"
BIN57 =  "w"  0  "Fail"
BIN58 =  "x"  0  "Fail"
BIN59 =  "y"  0  "Fail"
BIN60 =  "z"  0  "Fail"
BIN   =  "*"  177  "Untested"
MAP = {
                   ****111111111111****                   
                ***51111117111111111111***                
             ***5151115111111A111111111511***             
            **111111111111111115111115111518**            
          **1115111111171111111111111111511111**          
         **111111111111111111111111511111111111**         
       **1111111111111111111119111111111711111171**       
      **55111111111A111115111111911151117111111151**      
     **11111111119911111111111A11111111111111111111**     
    **115111111111111A111511111111111111111111111111**    
    *111111111919511111111111991911111111911111117111**   
   **1111111151111111171111A9991111511111191111111111**   
  *1111111111111111111111111111191111111111111111111111*  
  *111111111111151119515111A111911119111119111911911111*  
 *1111111111191119A1911111111911111111111191111111111111* 
 *111111111A1A511191111919191159191111111111111111111151* 
*11111551119A159711111919111119A19919999A9119911111111111*
*11111111111115111199A9111A117199111119191919111111111111*
*111111A1191511111111711111917111191119811111111111191111*
11111911199111191111A17191A1111119117119911911111991111157
1711111111511111111119A19191177911111195199119999919191871
1111A1117111991111911111A911799919191119119111911711991111
111111119191111919A111911A77111119199119711111919117115191
11119117991551119915119A11111111771191911191A9991111991A91
1111111119919911919591719711919917A11919911951111119191111
171151917119117951911191111911919119A119191911111911919111
1111151A11111111799997111171A1A9111A11A1711919191919119195
111A111919919571111511719791171117A11191119191991179119111
*19111111791111919171919991111911191111119111197179999919*
*151119971115911951919191917919719171191111111119119119A1*
*1191111119A117197111979919111191179111111111111911991111*
 *9111711A11119A1115177111A91119711199911919791199119191* 
 *171911191191111511111991111719911911117519111A1111A156* 
  *9911119A91911191755117A111A5519191111191711199911111*  
  **9995591911199959111A75111A117171111911191915999719**  
   *91A11171117119519775515111179111191A11117911191515*   
    *191199111919951971111A1991111A111911111111117195*    
    **9599911111111197171199111111111195511911111515**    
     **9115919A1A5191119A99111115111719111511115915**     
      **791711917111111111919151111151111151191111**      
       **A551111111111995111119111111919115111111**       
         **155511111151119115911111111111715511**         
          **1111A11181991951111111111911111115**          
            **515111919911111111119111151111**            
              **11119911179111111111115111**              
                ***11111111111111911111***                
                   ****711111111117****                   
}
}
